%%%%%
%G  %
%%  %
%. P%
%G .%
%%%%%