%%%%%
%G .%
%%. %
%. P%
%G .%
%%%%%