%%%%%
%G .%
%%  %
%. P%
%G .%
%%%%%