%%%%%%%%%%%%%%%%%%%%
%.   . %G  G%     .%
% %%   %%  %%   %% %
% %. %        %  % %
% %% % %%%%%%.% %% %
%O       P        .%
%%%%%%%%%%%%%%%%%%%%
