%%%%%%%%%%%%%%%%%%%%
%.   . %G  G%     .%
% %%   %%  %%   %% %
% %. %        %  % %
% %% % %%%%%%.% %% %
%.       P        .%
%%%%%%%%%%%%%%%%%%%%
