%%%%%%%%%%%%%%%
%.%G  G%     .%
% %%  %%   %% %
%        %  % %
% %%%%%%.% %% %
%      P     .%
%%%%%%%%%%%%%%%
