%%%%%%%%
%G    .%
%%. %  %
%.  P  %
%G  .  %
%%%%%%%%