%%%%%%%%%%
% %G  .%.%
% %%  %% %
%  G     %
% %%G%%% %
%      P %
%%%%%%%%%%