%%%%%%%%
%G .  .%
%%. %  %
%.. P. %
%G  . .%
%%%%%%%%