%%%%%%%%
%G    .%
%%. %%%%
%.  P%%%
%G% .  %
%%%%%%%%

[True Ture True True]